3
healthcare=urgency
10
1149039182
1173452910
1187130566
1187139238
1158156552
1103651721
1183630460
1173486994
1194803365
1191507764
healthcare=center
10
1173494091
1167369752
1174124536
1113220302
1113220461
1187086355
1187070117
1321544130
1160107524
1187086263
health_facility=nursinghome
12
1167369733
1174117156
1173440014
1185825687
1183684046
1321544535
1183621570
1183721302
1174116798
1187086212
1183708710
1149049228
