3
healthcare=urgency
29
1174116673
1113220232
1158156684
1321544597
1113220250
449815962
615304347
1321544100
1158156458
449815981
1193320878
1173425204
1191397561
1321544506
1187139259
1191393854
1158156607
1113220298
1174116811
1187130577
1174116945
1183684053
1159066073
1180139997
1174120925
1318750820
1155513071
1174116719
1173486579
healthcare=center
29
1174116673
1166052491
1159931405
1187119127
1167369752
449815805
1191393818
1174117147
1167369769
278730286
449815855
1158164526
1191453617
1173425089
1321544261
1187130568
1178253261
1173440083
1308678996
1174120917
1299524312
1308679000
1149024615
1321544041
1299524332
1187086193
1173486587
1159931517
1187119102
health_facility=nursinghome
43
1192542592
1192542594
1192542595
1192542597
1192542598
1192542599
1192542600
1192542601
1192542602
1192542603
1192542604
1193124738
1193124745
1193124746
1193130384
1193130386
1193130393
1193130396
1193130399
1193130401
1193130402
1193130404
1193130406
1193130408
1193130410
1193130412
1193130413
1193130416
1193130423
1193130424
1193130426
1193130427
1193130429
1193130431
1193130432
1193130441
1193130444
1193130446
1193130448
1193130450
1193130453
1193210438
1193218505
1193218550
